J V V V Z P V V V V
V V V B V V V Z V V
V P P V V P P V V V
R V V V V P P V V V
V V V P V V V V V V
P V V B V V V V V V
V V V V R V V V V V
V Z V V P V V V V V
V V C V V P Z V P B
V V V V V B V C V G
