JVPVVBPBPP
VVPZPPPVVP
PVVVPCVVZV
PZVVVVVPVV
PPPPVVPPVV
BVRVVVCVVP
VVPVVVPVVZ
PPVVPVPPVV
RVVPZVVPVV
BVVVVVVVVG
