J V P V V V V V V P
V V V V V V V C V V
V V V P V B V Z Z B
V Z V Z V Z V V R V
V C V P P V V P V V
V V V P V P P P V V
V V V V P V B V V V
V V V V V V V V V V
V V V V P V V V V V
V V V V P V V B R G
