JVVPBVRPPP
VVPPVPVPBV
ZVVVZVVPVV
PPPPVVVVRP
VVBPVVPPPP
VVPPVVPVZV
ZVVVVVVVVV
PVVPCVPPPV
PPPPVVPVVV
PBVZVVCVVG
