JPBPZVVBPP
VPVPVVVVPZ
VPCPPPVVVV
VVVVVVVRPV
VVVVZPPPPV
RPVVPPVVVZ
PPVVVVVPPP
BVVPVVZPVV
PPPPVVPPVV
BVVCVVVVVG
