JVVVZPVVVV
VVVBVVVZVV
VPPVVPPVVV
RVVVVPPVVV
VVVPVVVVVV
PVVBVVVVVV
VVVVRVVVVV
VZVVPVVVVV
VVCVVPZVPB
VVVVVBVCVG