J V V V V V V V V B
V P Z Z P V V V V V
V V V V V V C V P V
Z V V B V V B V P V
V V V P V V V P V V
V V V V V B V Z V V
V C P V V V V P P V
P R R V V V Z P V P
V V V V V V V P V V
V V V V V V V V P G
