JVVVVVVVVB
VPZZPVVVVV
VVVVVVCVPV
ZVVBVVBVPV
VVVPVVVPVV
VVVVVBVZVV
VCPVVVVPPV
PRRVVVZPVP
VVVVVVVPVV
VVVVVVVVPG