JVVZVVPPVP
VVVVVVVPVP
VVZVVVVVRV
PPVVZVZVVB
VCVVVBBVZV
VBVVVVVVVV
VVPVVVPVVV
PVVPPVVVVC
VVVVVVVVVV
VVVRVVVVVG