JVVVPVBPVR
PPVZPVPPVV
BVVPPCVVVZ
PVVPVVPPPP
PPVVVVVVVP
ZVVRPVVVBP
PPPPPCVPPP
ZVVVVVVVPV
BVVPZVVVVV
PPPPPPPVVG
