JVPVVVVVVP
VVVVVVVCVV
VVVPVBVZZB
VZVZVZVVRV
VCVPPVVPVV
VVVPVPPPVV
VVVVPVBVVV
VVVVVVVVVV
VVVVPVVVVV
VVVVPVVBRG