J Z V V V V P P V P
V V V V V V V P V P
V V Z V V V V V R V
P P V V Z V Z V V B
V C V V V B B V Z V
V B V V V V V V V V
V V P V V V P V V V
P V V P P V V V V C
V V V V V V V V V V
V V V R V V V V V G
