JVVVVPRPPP
VVBPVVVVVV
PPPPVPPZVB
ZVVVVPVVPP
PPCVPPVVVZ
BVVVVVVVVP
PVPPPZVVPC
VVVVVVVVVV
RVPVVPPVVV
PPPZVPBVVG
