J V V V V Z V Z P V
P V V V V P P V V Z
V P V V P V V V V V
R B V V V P V V V V
V V V P V V V C V V
V V V V V P V P V R
Z P V B V V V B V V
V V V V V V V C V B
V V V V V P Z V V V
V V V V V P V V V G
