JVVVVZVZPV
PVVVVPPVVZ
VPVVPVVVVV
RBVVVPVVVV
VVVPVVVCVV
VVVVVPVPVR
ZPVBVVVBVV
VVVVVVVCVB
VVVVVPZVVV
VVVVVPVVVG